+------------------------------------------------------------------------------+
|                            |                   e        |             +    d |
|  +----------{  }--------{  }------(  )---+  +--------+  |   +-+-+-+          | 
|  []s   lx  []  []             n          +  + out|   |  |   | w   |   +      |
|  +---------[]  []   q      -----  -----  +  +    |   |  |   |     |   +-[ ]--|
|            []  []            m           +  +    |   |                       |
|             \  / o       |               +  +        |  ------------  +-[ ]--|
|-----(  )----/  \------   +--------+      +  +        |                |    l |
|                              |    |      +  +        +-------         +------|
|          ----+---                 |      \   \                               |
|                              | l  |       \   \(  )--+  +----  -------   ----|
|      |       |       |       +----+        |  |      |  |         |          |
|      |       |       |                     {  }------+  +         |          |
|      |       |       |                               |  |         |  ------  |
|{  }-------++++++++   +                               +  +                    |
|                                                                   +          |
|        h  ++++++++   -----     ----  ---      ------------[  ]----|          |
|           |                                                  |    +--------  |
|----+  +---|   +           +----+         +-------+      -----+               |
|           |   |           |           +          |         | r               |
|     +         +       +   +    +      |     +              +----+----+       |
|     |                 |        |            |    |                           |
